Auditing
AutoCAD
Automotive
Art
Analytical Skills
Adobe Photoshop
Art Direction
Automation
Adobe Illustrator
Agile Methodologies
A + Certified - A320
A330 - AC Drives
AC Nielsen - ACPI
ACR - ADEA
ADFS - ADS-B
ADSI - AHDL
AHLTA - AIX Administration
AJAX - AMBA
AMBA AHB - AMX Programmer
ANCC - APA
APAC - APT
APV - ARMA
ARP - ASK MANMAN
ASME Standards - AT&amp;T Business Direct
AT&amp;T Connect - ATV Insurance
AU - AWS (DO NOT USE TAG Amazon Web Services)
AWS CWI - Ableton Live
Ableton Push - Academic Achievement
Academic Administration - Accelerated Reader
Accelerated Testing - Access to Information
Access to Justice - Account Direction
Account Directors - AccountRight
AccountRight Live - Accredited Cruise Counselor
Accredited Staging Professional - Aconex
Acoustic - Acronis
Acronis True Image - Active Adult Communities
Active Directory - ActiveX Data Objects (ADO)
Activism - Acute Care
Acute Coronary Syndrome - Adaptive Control
Adaptive Equipment - Ademco
Adenovirus - Administration CRM et ERP
Administration Jobs - Adobe Certified
Adobe Color - Adobe Marketing Cloud
Adobe Media Encoder - Adoption
Adoption Law - Advanced
Advanced Cardiac Life Support (ACLS) - Advertising Operations
Advertising Research - Aerobics
Aerodynamics - Affiliate Window
Affiliates - African Development
African Diaspora - Agency Relationship Management
Agency Selection - Agile Methodologies
Agile Modeling - Agricultural Law
Agricultural Lending - Air Defense
Air Duct Cleaning - Airborne School
Airbrush - Airline Economics
Airline Management - AlarmPoint
Albanian - Algorithm Design
Algorithm Development - Allergy Testing
Allgemein - Alternate Channels
Alternate Reality Games - Altium
Altium Designer - Amazon CloudFront
Amazon Dynamodb - Amdocs
Amek 9098i - American Studies
American Welding Society (AWS) - Anaerobic Digestion
Anaerobic Microbiology - Analytica
Analytical Applications - Analytique
Analyzation - Android SDK
Android Studio - Animal Care
Animal Chiropractic - Animation Direction
Animation Programming - Annual Reports
Annual Returns - Anti-aging Products
Anti-bribery - Antique Restoration
Antiques - Apache Cordova
Apache Derby - Apogee
Apollo - Appellate Practice
Appetizers - Apple TV
Apple Watch - Application Management Services
Application Migrations - Applications Development Management
Applications Software Development - Apportionment
Appraisers - Aquariums
Aquatic Ecology - ArcGIS
ArcGIS Engine - Archery
Archestra - Architectural Plans
Architectural Programming - Archtics Ticketing System
Arcplan - Arista
Arithmetic - Art Consulting
Art Criticism - ArtBase
ArtCAM - Articulate Studio
Articulate Suite - Artlantis Studio
Arts &amp; Crafts - Ashtanga
Asia Business Development - Asphalt Shingles
Aspose - Assessment Tools
Assessment for Learning - Asset-Backed Security (ABS)
Asset-backed Securitization - Association of Accounting Technicians (AAT)
Association of Chartered Certified Accountants (ACCA) - Asus
Asylum - Athletics
Atlas - Attachment Theory
Attendance Management - Audience Response Systems
Audience Segmentation - Audio Plug-Ins
Audio Post Production - Audit Committee
Audit Management - Aurora HDR
Australasia - Auto Glass Replacement
Auto Injuries - AutoMapper
AutoMod - Autodesk Vault
Autodock - Automobile Liability
Automotive - Automotive Technology
Automotive Writing - Avast
Avatars - Avid Newscutter
Avid Studio - Aweber
Awk - asdf
Business Analysis
Budgeting
Business Strategy
Business Process Improvement
Business Services
Business Planning
Branding
Business-to-Business (B2B)
Business Intelligence
Business Process
B-roll - B747
B757 - BBP
BBQ - BDMS
BEM - BIP
BIPV - BMC Remedy AR System
BMC Remedy Administration - BOLI
BOLO - BPD
BPF - BRI
BRIC - BTLS
BTO - Back Injuries
Back Office Operations - Backhaul
Backhoe - Backwards Design
Bacon - Badminton
Baggage Handling Systems - Balance Accounts
Balance Sheet - Balloons
Ballot Initiatives - Bandwidth Optimization
Bangla - Banking Relationships
Banking Software - Barcode
Barcode Scanners - Barracuda Spam Filter
Barracuda Spam Firewall - Base24
Baseball - Bases de données client et analyse de données
Bases de données clients - Basware
Batch Control - Battery Management Systems
Bauxite - Beamforming
Beams - Bedding
Bedrock - Behance
Behat - Behavioral Health
Behavioral Intervention - Beleuchtung und Rendering
Bell Labs - Benefits Management
Benefits Negotiation - Berufliche Weiterentwicklung
Bespoke - Biacore
Biamp - Bicycle &amp; Pedestrian Planning
Bicycle Accidents - Bids
Big Band - Bikini
Bikram Yoga - Bill Reconciliation
Bill Review - Bind
Binders - Bioassay
Bioavailability - Biodegradation
Biodiesel - Biogeography
Biography - Biologists
Biology - Biomedical Sciences
Biomedicine - Bioreactor
Bioremediation - Biotherapeutics
Biotransformation - Birthdays
Biscuits - Black Box Testing
Black and White - Blacksmithing
Bladder Cancer - Block Diagrams
Block Printing - Blood Products
Blood Transfusion - Blower Door Testing
Blowers - BlueJ
Bluebeam - Bluetooth Low Energy
Bluetooth Marketing - Board Operation
Board Presentations - Body Contouring
Body Image - Boinx
Boinx Software - Bone Densitometry
Bone Density - Book History
Book Illustration - BookMaster
Bookbinding - Boost
Boost C++ - Borland C++ Builder
Borland Delphi - Bottom Line Results
Boudoir - Bowtie
Box - Brain Gym
Brain Injury - Branch Operation
Branchless Banking - Brand Finance
Brand Health Tracking - Brand Strengthening
Brand Tracking - Brazing
Breach Of Contract - Breast Surgery
Breathwork - Bridge Rehabilitation
Bridging - British Literature
British Politics - Broadcast Operations
Broadcast Pix - Brochure Websites
Brochures - Brownfield
Brownies - Buddhist Psychology
BuddyPress - Budget Process
Budget Proposals - Build Outs
Build Projects - Building Coalitions
Building Code Research - Building Information Modeling (BIM)
Building Inspections - Building Permits
Building Physics - Built Environment
Built-ins - Bundling
Bungalows - BurrellesLuce
Burrito - Business Analysis Planning &amp; Monitoring
Business Analytics - Business Case Preparation
Business Case Production - Business Decision Making
Business Design - Business Expansion
Business Formation - Business Interruption
Business Interruption Claims - Business Method Patents
Business Minded - Business Parks
Business Partner Relations - Business Process Execution Language (BPEL)
Business Process Improvement - Business Requirements
Business Rescue - Business Software and Tools
Business Solution - Business Transactions
Business Transformation - Business Writing
Business-Software - Buy-in
Buy-sell Agreements - Bylined Articles
beta 7 - beta 7
Customer Service
Communication
Company Research
Change Management
Coaching
Construction
Customer Relationship Management (CRM)
Contractual Agreements
Customer Satisfaction
Contract Negotiation
C - C4I
C4ISR - CAESAR
CAESAR II - CATSWeb
CATT - CCM
CCMA - CDMA2000
CDMC - CFRA
CFRE - CINEMA 4D Studio
CIO Advisory Services - CMDR
CMF - CNSS
CO-CCA - COSO Framework
COSS - CQ5
CQC - CS5.5
CS6 - CTA
CTAs - Cabinetry
Cabins - Cakes
Cakewalk - Call of Duty
Call to Action - Campus Management
Campus Ministry - Canning
Cannon - Capital Acquisitions
Capital Adequacy - Captive Insurance
Capture - Carcinogenesis
Card Access - Career Counseling
Career Development - Carrom
Cars - Cash Flow Management
Cash Flow Reporting - Catalog Development
Catalog Layout - Cavium
Cd - Cellular Automata
Cellular Communications - Ceramic Materials
Ceramic Processing - Certified Fraud Examiner
Certified Fund Raising Executive - Certified Quality Manager
Certified Quality Technician - Change Communications
Change Consulting - Channel Sales Development
Channel Strategy - Charitable Trusts
Charities - ChemDraw
ChemSketch - Chess
Chest Tubes - Chilled Water
Chimera - ChordPulse
Chordiant - Cimatron
Cincom - Cisco Information Security
Cisco MARS - Citrus
City Halls - Clairsentient
ClamAV - Classroom Delivery
Classroom Design - Clicktale
Client Access - Client Side
Client Side Scripting - Clinical Excellence
Clinical Governance - Clinical Trials
Clinical Workflow - Cloud Applications
Cloud Communications - Co-production
Co-promotion - Cocoa
Cocoa Touch - Cognitive Assessment
Cognitive Behavioral Therapy (CBT) - Collaborative Application Markup Language (CAML)
Collaborative Decision-making - College Education Planning
College Football - Colorburst
Colorectal - Command Prompt
Commedia dell'Arte - Commercial Mortgage-Backed Security (CMBS)
Commercial Mortgages - Commissioning Engineers
Commissioning Management - Communications Law
Communications Management - Community Leadership
Community Management - Company Launch
Company Law - Compensation Strategies
Compensation Structures - Complex Analysis
Complex Event Processing - Component Testing
ComponentOne - Computational Fluid Dynamics (CFD)
Computational Genomics - Computer Industry
Computer Information Systems - Computrace
Computrition - Concerto
Concerts - Conference Facilitation
Conference Interpreting - Congestion Management
Congregational Development - Conservative
Conservatories - Construction Engineering
Construction Environmental Management - Consumer Electronics
Consumer Financing - Contact Improvisation
Contact Lenses - Content Management Systems
Content Management Systems (CMS) - Continuity Management
Continuity of Government - Contract Writing
Contract to Perm - Controllers
Controllership Functions - Cooperation
Cooperative - Coral Reefs
Corda - Coronary Artery Disease
Corp-Corp - Corporate Identity
Corporate Image - Corporate Tie-ups
Corporate Training - Cosmetic Dentistry
Cosmetic Medicine - Cost Transparency
Cost Variance Analysis - Coupons
Courier IMAP - Crackers
Cracking - Creative Executions
Creative Fiction - Creativity
Creativity Skills - Crestron
Crew Coordination - Critical Care
Critical Care Medicine - Cross Stitch
Cross-Channel - Crowdsourcing
Crown - Csh
Csound - Cultural Research
Cultural Resource Management - Custodians
Custody Evaluations - Customer
Customer Acceptance - Customer Lifecycle Management
Customer Loyalty - Customs Regulations
Customs Valuation - Cytokines
Cytology - comScore
Design
Databases
Data Analysis
Digital Marketing
DES
Decision-Making
Digital Media
Drawing
DOS
Development Tools
D - D7000
D800 - DAX
DBAccess - DCAA
DCB - DDM
DDMI - DEXA
DFA - DHCPv6
DHS - DL1
DLC - DMR
DMRB - DNA microarray
DNA quantification - DOL
DOM Scripting - DRBD
DRBFM - DSLR Video
DSLR Video Tips - DV
DV Camera Operator - DVI
DVP&amp;R - Daily Reports
Dairy Products - Dance Medicine
Dance Music - Dassault Systèmes
Data - Data Center Construction
Data Center Design - Data Destruction
Data Dictionary - Data Infrastructure
Data Integration - Data Monetization
Data Monitoring - Data Reconciliation
Data Recording - Data Stewardship
Data Storage Technologies - Data Warehouse Appliances
Data Warehouse Architecture - Database Applications
Database Auditing - Database Systems
Database Testing - Datensicherung und Wiederherstellung
Dating Coach - Deal Closure
Deal Creation - Dealer Training
Deals - Debtor/Creditor
Debtor/creditor Law - Decision Trees
Decision-Making - Deductive Reasoning
Deduplication - Defect Elimination
Defect Identification - Defensive Driving
Defensive Tactics - Delegation
Deliberation - Delphi
Delphi Certified - Demand Planning
Demand Response - Demography
Demolition - Dental Imaging
Dental Industry - Department Administration
Department Budget Management - Dependency Management
DeployStudio - Derivative Operations
Derivatives - Design &amp; Illustration
Design Analysis - Design Flow
Design Foundations - Design Standards
Design Strategy - Design-Build
Design-Business - Desktop Deployment
Desktop Imaging - Destructive Testing
Detention - Development Agreements
Development Applications - Development Programs
Development Projects - Deviations
Device Anywhere - Dhcpd
Dia - Dialogue Editing
Dialogues - Die Casting
Die Cutting - Difficult Situations
Diffraction - Digital Architecture
Digital Archiving - Digital Communication
Digital Communication Strategy - Digital Electronics
Digital Engagement - Digital Innovation
Digital Integration - Digital Networking
Digital Painting - Digital Rhetoric
Digital Rights - Digital Telephony
Digital Transformation - Dimensional Letters
Dimensional Management - Direct Action
Direct Banking - Direct Marketing
Direct Materials - Directing Others
Directing Talent - Disability Insurance
Disability Law - Discipleship
Discipleship Training - Discrete
Discrete Choice - Diseño de software
Diseño gráfico 3D - Disordered Eating
Disparities - Dispositions
Dispositivos - Distress Properties
Distress Sales - Distributed Systems
Distributed Team Management - Distribution Strategies
Distribution Systems - Diversity Recruitment
Diversity Relations - DocAve
DocBook - Documaker
Document Automation - Document Review
Document Type Definition (DTD) - Dodge
Doer - Dolly Grip
Dolphin - Domestic Politics
Domestic Relations - Donuts
Doodling - Double Entry
DoubleClick - Draft
DraftSight - Drainage Solutions
Drainage Studies - Dream Interpretation
Dreamviewer - Drive
Drive Change - Drools
Drop Ship - Drug Repositioning
Drug Resistance - Drywall
Dtrace - Duo
Duplexes - DxO ViewPoint
Dye Sublimation - Dynamic Programming
Dynamic Random-Access Memory (DRAM) - Dynatrace
Dynsim - Développement professionnel
Développement web back-end - duduf.net
English
Event Planning
Editing
Entrepreneurship
Email
Employee Benefits Design
Energy
Electronics
Enterprise Software
E-commerce
E Commerce - E-Mail-Marketing
E-Prime - E-democracy
E-disclosure - E-training
E-zines - EASE
EBA - ECG Interpretation
ECI - EDGAR filings
EDI ANSI X12 - EEO/AA Compliance
EEPROM - EIP
EIS - EMC Products
EMC Replication Manager - EMSA
EMT - EOI
EOL - EPL
EPMA - ERDAS Imagine
ERDF - ESI
ESI Processing - ETD
ETFs - EVO
EVOC Instruction - Eaglesoft
Ear Candling - Early Warning Systems
Early-stage Startups - East Asian Studies
East Asian affairs - EclipseLink
Eclipsys - Economic Capital
Economic Data Analysis - Economic Research
Economic Sanctions - Eczema
Eddy Current - Editorial Consulting
Editorial Illustrations - Education Reform
Education Savings - Educational Marketing
Educational Materials - Edutainment
Efectos de imagen - Ehcache
Eiffel - Election Law
Election Monitoring - Electrical Diagnosis
Electrical Distribution Design - Electrical Troubleshooting
Electrical Wiring - Electrochemical Engineering
Electrochemistry - Electron Optics
Electronic Cigarette - Electronic Hardware
Electronic Instrumentation - Electronic Structure
Electronic Submissions - Electroporation
Electrospinning - Elinchrom
Elite Webview - Email Distribution
Email Encryption - Embarcadero
Embassies - Embossing
Embraces Change - Emergency Planning
Emergency Power - Emerging Technologies
Emerging Trends - Emotionally Focused Therapy
Empirical Research - Employee Health
Employee Interaction - Employee Training
Employee Turnover - Employment Rights
Employment Standards - Enclosure Design
Enclosures - End-of-Life Care
End-to-End Project Management - Endowments
Endpoint Protection - Energy Conversion
Energy Derivatives - Energy Plus
Energy Policy - Energy Work
Enertia - Engine Rebuilding
Engineered Labor Standards - Engineering Management
Engineering Mathematics - English as a Second Language (ESL)
English for Specific Purposes - Enrollments
Enroute - Enterprise Architecture Planning
Enterprise Asset Management - Enterprise Information Systems
Enterprise Integration - Enterprise Portfolio Management
Enterprise Product Development - Enterprise Systems
Enterprise Systems Development - Entertainment Systems
Entertainment Technology - Entry-level
Entwicklertools - Environmental Consulting
Environmental Control - Environmental Interpretation
Environmental Investigation - Environmental Projects
Environmental Protection - Environmental Strategies
Environmental Stress Screening - Epic
Epic Editor - Epoxy Flooring
Epson - Equine Reproduction
Equine Therapy - Equipment Supply
Equipment Testing - Equity Swaps
Equity Trading - Escalation Process
Escalation Resolution - Essential Training
Establishing New Accounts - Estimates
Estimators - Ethical Theory
Ethical Trade - Eudora
Euphonium - European Security
European Studies - Event Driven
Event Driven Programming - Events
Eventum - Exact Globe
Exact Online - Excel Pivot
Excel Services - Exchange Traded Derivatives
Exchequer - Executive Counsel
Executive Decision-making - Executive Presentation Development
Executive Presentation Skills - Executive Travel
Executive Visibility - Existing Home Sales
Existing Homes - Expedition PCB
Expeditionary Warfare - Experiential Education
Experiential Events - Expert Networks
Expert Reports - Export Administration
Export Control Compliance - Expression Design
Expression Web - Extensity
Exterior - Extracurricular Activities
Extradition - Eyelid Surgery
Eyeliner - eCRF
eCRM - eFax
eForms - ePortfolio
ePremis - eZ Publish
ebXML - eラーニング
Finance
Financial Analysis
Fundraising
Facility Management (FM)
Food &amp; Beverage
Forecasting
Facilitation
Financial Risk
Financial Reporting
Facebook
F - F9
FAA - FAS
FAS 133 - FCAW
FCC License - FDR
FDS - FF&amp;E
FF&amp;E Procurement - FICC
FICON - FIX32
FL Studio - FMCSR
FME - FPA
FPC 1 - FRS
FRx - FTO Analysis
FTP - FX Swaps
FXHome - Facebook API
Facebook Ads Create Tool - Facial Rigging
Facial Trauma - Facility Start-up
Facillitation - Factual
Faculty Development - Fairness Opinions
Fairy Tales - Family Events
Family Fitness - Family Studies
Family Therapy - Fares
Farm &amp; Ranch Insurance - Fashion History
Fashion Illustration - Fast Turnaround
Fast-Moving Consumer Goods (FMCG) - Fatigue Analysis
Fatigue Management - Faux Bois
Faux Finish - Feature Testing
Feature Writing - Federal Employment Law
Federal Enterprise Architecture - Federal Regulations
Federal Reporting - Feldenkrais
Fellowships - Ferroelectrics
Fertility - Fiber Optic
Fiber Optic Cable - Fibromyalgia
Fiction - Field Force Automation
Field Force Effectiveness - Field Studies
Field Supervision - Figure Drawing
Figure Painting - File Transfer
FileBound - Filipino
Fillers - Film Marketing
Film Photography - FinCEN
FinTech - Finale
Finalization - Financial Aid Administration
Financial Analysis - Financial Econometrics
Financial Economics - Financial Justification
Financial Law - Financial Performance
Financial Performance Improvement - Financial Risk
Financial Risk Management - Financial Technology
Financial Tracking - Findlaw
Fine Art - Finite Difference
Finite Difference Method - Fire Investigation
Fire Management - Fire Sprinkler Systems
Fire Suppression Systems - Fireplaces
Fireproofing - First Impressions
First Look - Fishbowl
Fishbowl Inventory - Fitness Center
Fitness Consulting - Fixed Asset Depreciation
Fixed Asset Management - Fixer Uppers
Fixing - Flanges
Flare - Flash Photography
Flash Player - Flavor Chemistry
Flavors - Flex
Flex Builder - Flexible Manufacturing
Flexible Schedule - Flight Nursing
Flight Planning - Flixel Photos
Floating Production, Storage and Offloading (FPSO) - Flooring
Floorplanning - Flow Charts
Flow Chemistry - Fluid Dynamics
Fluid Effects - Fluorometer
Fluoropolymers - Focus
Focus Groups - Folk Dance
Folklore - Food &amp; Beverage
Food &amp; Drug Law - Food Manufacturing
Food Marketing - Food Sensitivities
Food Service Operations - Footwear
For Sale By Owner - Foreclosures
Forefront - Foreign Military Sales
Foreign National Loans - Forensic Biology
Forensic Chemistry - Forest
Forest Carbon - Form 5500
Form 5500 preparation - Former Soviet Union
Forming - Forrester
Forte - Forwards
Fossil Fuel - Fotografía para aficionados
Fotos - Fountains
Fourier Analysis - Fracture Care
Fracture Mechanics - Frameworks und Bibliotheken
Frameworks und Skriptsprachen - Fraud Claims
Fraud Detection - FreeNAS
FreeRADIUS - Freeswitch
Freeway - French Law
French Literature - Fringe Benefits Tax (FBT)
Frisbee - FrontPage
FrontRange - Fuel Cells
Fuel Economy - Full Life Cycle Development
Full Life Cycle Implementation - Function Modules
Function Point Analysis - Functional Management
Functional Medicine - Fund Derivatives
Fund Of Funds - Fungal
Funk - Fusion 360
Fusion Charts - fMRI
factual.com - factual.com
Government Agencies
Grocery
Government
Graphic Design
Google Groups
Gas
Graphics
Grant Writing
General Ledger
German
G Suite - G8D
GAAS - GC-MS
GCCS - GE Proficy
GE Workout - GFP
GFS - GIMP
GIPS - GLM
GLONASS - GML
GMLAN - GNU Debugger
GNU Make - GPFS
GPG - GPS Units
GR&amp;R - GSA Contracting
GSA Schedule - GSS
GSX - GUI development
GUI test automation - Gait
Gait Analysis - Gallery Administration
Gallery Management - Game Design
Game Design + Development - Game Physics
Game Programming - GamePlayKit
Gamebryo - Gamma Knife
Gamma Spectroscopy - Garde Manger
Garden - Gas Accounting
Gas Analysis - Gas Stations
Gas Storage - Gate Level Simulation
Gated Communities - Geant4
Gear - Gel Extraction
Gel Nails - Genarts
Gender Analysis - Gene Synthesis
Gene Targeting - General Assignment Reporting
General Aviation - General Corporate Practice
General Correspondence - General Liability Defense
General Linear Models - General Programming
General Public - Generalist Profile
Generalists - Generators
Generic Drugs - Genetic Engineering
Genetic Epidemiology - Genotyping
Genre Fiction - GeoStudio
GeoTools - Geographic Analysis
Geographic Expansion - Geomagic
Geomarketing - Geomorphology
Geopak - Geospatial Intelligence
Geospatial Modeling - Gerber Accumark
Gerber Composer - German Translation
German to English - Gestion de projet
Gestion de projets logiciels - Gestión de servicios IT
Gestión y organización de proyectos - Giclee Prints
Gif Animator - Gifted Children
Gifted Education - GitLab
Github - Glass Painting
Glassblowing - Glitter Tattoos
Global 8D - Global Business Planning
Global Career Development Facilitator - Global Contract Negotiation
Global Cross-Functional Team Leadership - Global Engineering
Global Events - Global Implementations
Global Infrastructure Management - Global Media Relations
Global Mobility - Global Policy
Global Politics - Global Sales
Global Security - Global Teaming
Global Teams - Globus
Glock - Gluten Free
Gluten Intolerance - Go-to-market Strategy
GoDaddy - Goal Seek
Goats - Golf
Golf Club Repair - Goniometer
Gonstead Technique - Google Ad Planner
Google AdSense - Google Attribution
Google Audience Center - Google Contacts
Google Content Experiments - Google Fotos
Google Gadgets - Google Nexus
Google Origami - Google Search Console
Google Sheets - Google TensorFlow
Google Trends - Gospel
Gospel Music - Government Administration
Government Advocacy - Government Contract Negotiations
Government Contracting - Government Loans
Government Officials - Government Securities
Government Services - Graduate Assessment
Graduate Entry - Grain
Gram Staining - Grant Preparation
Grant Reviewing - Grapher
Graphic Animation - Graphical Models
Graphical User Interface (GUI) - Graphite Drawing
Graphology - Grassroots Fundraising
Grassroots Lobbying - Great Plains
Greater China - Green Events
Green Hills - Green Projects
Green Purchasing - Greenfoot
Greenhouse - Grid Connection
Grid Generation - Grocery
Grocery Industry - Ground Penetrating Radar
Ground Support Equipment - Group Accounts
Group Activities - Group Events
Group Exercise - Group Meetings
Group Moves - Group Therapy
Group Training - Growth Capital
Growth Factors - GruntJS
Gráficos para web - Guest Lecturing
Guest Recovery - Guidestar
Guidewire - Gutter Cleaning
Gutters - Gyrokinesis
Gyrotonic - global HCM
HTML
Heavy Equipment
Hospitals
Higher Education
History
Healthcare
Hospitality Industry
Helping Clients Succeed
Healthcare Management
HTML5
H&amp;E staining - H15.5
H1B - HAP
HARO - HBV
HBase - HCV
HD Camera Operation - HDPE
HDR - HEC-2
HEC-HMS - HEV
HF - HIS
HIS Implementation - HMIs
HMO - HP Application Lifecycle Management
HP Blade - HP Network Node Manager
HP Networking - HP QuickTest Professional (QTP)
HP Server Hardware - HP3000
HP9000 - HPTLC
HPV - HR Operations
HR Outsourcing (HRO) - HRA
HRB - HSEQ
HSI - HSS
HSSE - HTML Scripting
HTML5 - HUET
HUMINT - HaaS
Habeas Corpus - Hair Cutting
Hair Extensions - Halloween
Halloween Costume - Hand Modeling
Hand Percussion - Handbooks
Handbrake - Hands-on Design
Hands-on Technical - Hansen
Hansoft - Hard Money Lending
Hard Money Loans - Hardware Bring-up
Hardware Deployments - Hardware Security
Hardware Sizing - Harmonics
Harmonisation - Harvest
Harvesting - Havok
Hawk - Hazardous Areas
Hazardous Chemicals - Headcount
Headcount Management - Healing Touch
Health - Health Benefits Administration
Health Care Fraud - Health Counseling
Health Economics - Health Insurance Exchanges
Health Journalism - Health Promotion
Health Psychology - Health Workforce
Health Writing - Healthcare Information Technology (HIT)
Healthcare Management - Hearing Tests
Hearings - Heat Pumps
Heat Sinks - Heavy Haul
Heavy Industry - Hedge Funds
Hedge Trimming - Helmets
Help Authoring - Hematopathology
Hematopoiesis - Herbal Medicine
Herbicides - Herpetology
Herramientas de oficina - Hevc
Hex - High Content Screening
High Court - High Intensity Interval Training
High Intensity Training - High Performance Driving
High Performance Organizations - High Power
High Pressure - High Sense Of Urgency
High Sierra - High Stress Environment
High Tech Sales - High Volume Staffing
High Yield - High-speed Digital Design
High-volume Recruiting - Highest &amp; Best Use
Highway Capacity Software - Hip Arthroscopy
Hip Hop - Hispanic Marketing
Histograms - Historical Fiction
Historical Geography - History Of Ideas
History Of Medicine - Hitbox
Hitting Targets - Hog
Hogan Assessments - Holidex
Holistic Education - Home Appliances
Home Audio - Home Finding
Home Health Agencies - Home Retention
Home Search - Homebirth
Homebrewing - Homeschooling
Homesite - Honeycomb
Honeymoons - Horizon
Horizon Meds Manager - Horse Properties
Horse Racing - Hospital Contracting
Hospital Information Systems - Hospitality Industry
Hospitality Law - Hosted Chef Server
Hosted Microsoft Exchange - Hot Tubs
Hot Water - Hours of Service
House Blessings - Housebuilding
Household - HtmlUnit
HttpUnit - Hula Hoop
HulloMail - Human Evolution
Human Factors - Human Nutrition
Human Osteology - Human Rights Research
Human Security - Humidification
Humidity - Hurricane
Huthwaite SPIN Selling - Hydration
Hydraulic Calculations - Hydrogen
Hydrogen Fuel Cells - Hydrophobic Interaction Chromatography
Hydroponics - Hyper-V
HyperChem - Hyperion Interactive Reporting
Hyperion Performance Suite - Hypertrophy
Hypervisor - Hysteroscopy
Information Technology
Interpersonal Skills
Information Systems
Internal Audit
Integration
Insurance
Investments
Interviewing
Invoicing
Integrated Marketing
I&amp;C - IAR Embedded Workbench
IAS 39 - IBM Certified Associate System Administrator
IBM Certified Database Associate - IBM Rational Rhapsody
IBM Rational System Architect - IBM pSeries
IBMS - ICD
ICD-10 - ICP-OES
ICPR - IDLE
IDM - IEC 61850
IEC 62304 - IFMA
IFR - IICRC Certifications
IICRC Certified - ILS
ILT - IMSDB
IMSS - IP Addressing
IP Audit - IPB
IPC - IPRO
IPS - IRC
IRCA - IS-700
IS-95 - ISDX
ISE - ISO 18001
ISO 2000 - ISO Procedures
ISO Standards - ISU
ISV - IT Executive Management
IT Financial Management - IT Performance Management
IT Portfolio - IT Service Delivery
IT Service Management - ITCAM
ITCH - ITサポート
ITサービスのマネジメント - Ice Carving
Ice Climbing - Ideas Development
Ideas NX - Idoc Script
Idrisi - Iluminación y render
Ilustración - Image Pro
Image Processing - Imagery Analysis
Imagineer Systems - Immunity
Immunization - Impact Assessment
Impact Evaluation - Import Export
Import Logistics - In Vitro Diagnostics (IVD)
In Vitro Fertilization (IVF) - InMagic
InRoads - Income Property
Income Property Sales - Independent Contributor
Independent Film - Indian Taxation
Indian cuisine - Individual Returns
Individual Work - Industrial Automation
Industrial Buildings - Industrial Microbiology
Industrial Minerals - Industrial Water Treatment
Industrialization - InfinityQS
Infinium - InfoComm CTS
InfoLease - Informal Learning
Informatica Administration - Information Integration
Information Literacy - Information Search
Information Security - Information Technology Training
Information Theory - Infrared Photography
Infrared Thermal Imaging - Ingenuity Pathway Analysis
Ingres - InkQuest
InkScribe - Inorganic Chemistry
Inorganic Materials - Insite
Insomnia - Installation &amp; Dismantle
Installation Coordination - Institutional Portfolio Management
Institutional Projects - Instructor Development
Instructor-led Training - Insulin Resistance
Insurance - Insurance Training
Insurance Verification - Integrated Library Systems
Integrated Management Systems - Integrated Systems
Integrated Thinking - Intel 8085
Intel Architecture - Intelligence
Intelligence Analysis - Inter-departmental Cooperation
Inter-departmental Coordination - Interactive Marketing Strategy
Interactive Media - Interchange Management
Intercollegiate Athletics - Interest Rate Derivatives
Interest Rate Hedging - Intergenerational Wealth Transfer
Intergovernmental Affairs - Intermediates
Intermedio - Internal Marketing
Internal Mobility - International Auditing Standards
International Awareness - International Connections
International Credit - International Growth
International HR - International Marketing
International Media - International Project Management
International Property - International Shipping
International Staffing - International Transfers
International Travel - Internet Governance
Internet Information Services (IIS) - Internet Security
Internet Service Provider (ISP) - Internet strategy development
Internet und Social Media - Interprofessional Education
Interrogation - Interventions
Interview - Intrapreneurship
Intrastat - Intune
Invasive Species - Invertebrate Zoology
Inverters - Investment Casting
Investment Communications - Investment Properties
Investment Property Financing - Invisalign
Invisible Braces - Ionic Liquids
Ipchains - Ironing
Ironport - Isometric
Isometric Drawings - Item Analysis
Item Master - iBuy
iBwave - iMIS
iMacros - iPhone
iPhone + iPad - iSight
iStopMotion - iZotope
iZotope RX 4 - information system design
Java
Javascript
JQuery
Journalism
Job Scanning
Java Enterprise Edition
Job Description Development
Journals
Journal Entries
Joint Ventures
J# - J-STD-001
J1939 - J2ME Development
JAAS - JAIN SLEE
JAMF Software - JAX-RPC
JAX-WS - JBL
JBPM - JBoss ESB
JBoss Seam - JCAHO
JCAPS - JCO
JCR - JCreator
JD Edwards - JDE CNC
JDE Enterprise One - JDK
JDO - JEDEC
JES2 - JGrasp
JGroups - JIS
JIT Production - JMX
JMeter - JOGL
JOPES - JPA
JPAS - JPOS
JProbe - JRockit
JRuby - JSFL
JSLint - JSONP
JSP440 - JSTOR
JSUnit - JSystem
JTA - JTest
JUnit - JVs
JWICS - Jack Henry
Jackets - Jade
Jaguar - Janus
Japanese - Japanese Culture
Japanese History - Japanese Translation
Japanese to English - Jasper
Jasper Reports - Java AWT
Java Applets - Java Concurrency
Java Database Connectivity (JDBC) - Java Frameworks
Java Message Service (JMS) - Java Performance
Java RMI - Java Virtual Machine (JVM)
Java Web Server - Java2D
Java3D - JavaCard
JavaFX - JavaScript Frameworks
JavaScript Libraries - JavaServer Pages (JSP)
JavaServer Pages Standard Tag Library (JSTL) - Jave
Javelin - Jazz Band
Jazz Dance - Jazz Improvisation
Jazz Piano - Jeep
Jeet Kune Do - Jena
Jenark - Jet Engines
Jet Fuel - Jets
Jetties - Jewelry Design
Jewish Education - JiBX
Jib - Jigsaw
Jimmy Jib - Jingles
Jini - Jiu-Jitsu
Jive - Job Analysis
Job Applications - Job Coordination
Job Costing - Job Diva
Job Estimating - Job Matching
Job Order Contracting - Job Pricing
Job Readiness - Job Satisfaction
Job Scanning - Job Search Strategies
Job Searching - Job Shop
Job Skills - Job Transition
JobBoss - Jobvite
Jogging - Joinery
Joining Formalities - Joint Military Operations
Joint Operations - Joint Replacement
Joint Test Action Group (JTAG) - Jones Act
Joomla - Jordan
Journal Entries - Journalism
Journalism Education - Joyent
Judgment Collections - Judicial Review
Judo - Julia
Jumbos - Jumpmaster
Jumpstart - Juniors
Juniper - Juniper Switches
Junk Removal - Jurisdiction
Jurisprudence - Jury Trials
Justice - Juvenile Delinquency
Juvenile Justice - Juxtaposer
jBase - jQuery
jQuery Mobile - jQuery UI
Key Performance Indicators
Kaizen
K-12 Education
Knowledge Management
Kanban
Key Account Development
Knowledge Sharing
Knowledge Base
KYC
Kindergarten
K-1 - K-8
K-9 Handler - K2.net 2003
K4 - KCS
KDB - KDE
KDevelop - KIVA
KMDF - KNX
KOL - KOL Identification
KOL Management - KPI
KPI Dashboards - KPI Reports
KRA - KT
KVM Switches - KWP2000
KXEN - Kabbalah
Kafka - Kaizen
Kaizen Blitz - Kaledo
Kaledo Print - Kaleidagraph
Kali - Kalido
Kalman filtering - Kana
Kanban - Kannel
Kantar - Karat
Karate - Karl Fischer Titration
Karma - Karriere-Entwicklung
Karst - Kaseya
Kaspersky - Katana
Kathak - Kayako
Kazakh - Keen Planner
Keil - Kenan Arbor
Kenan FX - Kendo Ui
Kenexa - Kepner-Tregoe
Kepware - Keratin Treatment
Keratoconus - Kerio
Kerkythea - Kernel Debugging
Kernel Drivers - Kernel-based Virtual Machine (KVM)
Kettle - Kevlar
Key Account Acquisition &amp; Retention - Key Account Growth
Key Account Handling - Key Account Relationship Building
Key Account Relationships - Key Client Relationships
Key Driver Analysis - Key Management
Key Message Development - Key Opinion Leaders
Key Performance Indicators - Key Person Protection
Key Systems - KeyShot
Keyboard Programming - Keyframe Animation
Keyhole Markup Language (KML) - Keyless Entry
Keynote - Keystone
Keyword Advertising - Keyword Generation
Keyword Planner - Keywording
Keywords - Khronos Group
KiCAD - Kia
Kibana - Kickstart
Kickstarter - Kidney
Kidney Cancer - Kidney Transplant
Kids Rooms - Kidswear
Kilns - Kimball Methodologies
Kimball Methodology - Kindergarten
Kindermusik - Kindness
Kinect - Kinesio Taping
Kinesiology - Kinetic Sculpture
Kinetic Typography - King III
Kingdom Suite - Kintana
Kintera - Kiosk Development
Kirkpatrick - Kiss
Kitchen &amp; Bath Design - Kitchen Remodeling
Kitchenware - Kitesurfing
Kitting - Klarity
Klocwork - Knee
Knee Pain - Knime
Knitting - KnockoutJS
Knoppix - Knowledge Acquisition
Knowledge Base - Knowledge Discovery
Knowledge Engineering - Knowledge Management Systems
Knowledge Mobilization - Knowledge Process Outsourcing (KPO)
Knowledge Representation - Knowledge-based Systems
KnowledgeLake - Kobobooks
Kodak - Kodi
Kodu - Koha
Kohana - Koi Ponds
Koine Greek - Kommunikation und Zusammenarbeit
Komodo - KompoZer
Kondor+ - Kontakt
Korean - Korg
Kosher - Koyo
Krakatoa - Kreativität
Kronos - Kronos WFC
Ksh - Kubuntu
Kuka - Kundalini
Kundalini Yoga - Kung Fu
Kurdish - Kyocera
Kyoto Protocol - knitr
Leadership
Logistics Management
Local Marketing
Legal Issues
Linux
Leadership Development
Laboratory Skills
Lean Manufacturing
Litigation
Legal Writing
L&amp;D - LAMP
LAMP administration - LCD Projectors
LCD TV - LDI
LDO - LED Lighting
LED Lighting Systems - LIFO
LIN - LLQP
LLU - LON
LOPA - LPS Desktop
LPT - LSP
LSS - LWAPP
LWD - Labor Certification
Labor Compliance - Labor Strategy
Labor Support - Laboratory Technicians
Laboratory Techniques - Lakefront
Lakefront Homes - Land Clearing
Land Conservation - Land Use
Land Use Issues - Landlord/Tenant Matters
Landlords Insurance - Landscape Maintenance
Landscape Management - Language Integrated Query (LINQ)
Language Learning - Lapidary
Lapping - Large Group Interventions
Large Groups - Large Scale Transformation
Large System Implementations - Laser Cutting
Laser Dentistry - Laser Therapy
Laser Welding - Lateral Thinking
Lathe - Latin music
Latisse - Launch Vehicles
Launches - Law Firm Administration
Law Firms - Lay-out
Layer 2 - Lead Cultivation
Lead Development - Leadership Accountability
Leadership Counseling - Leading Development Teams
Leading Discussions - Lean Business Processes
Lean Construction - Lean Management
Lean Manufacturing - Lean UX
Lean Warehousing - Learning Management
Learning Management Systems - Lease Documentation
Lease Financing - Leave of Absence
Leave of Absence Administration - Legacy Giving
Legacy Modernization - Legal Contract Negotiation
Legal Contract Review - Legal Letters
Legal Liability - Legal Process
Legal Process Outsourcing - Legal Solutions
Legal Solutions Plus - Legislation
Legislative Affairs - Lemon Law
Lending Solutions - Leopard
Lesson Planning - Level A &amp; B qualified
Level Building - Leveraging Strategic Partnerships
Levies - Liability Analysis
Liaison - Library Instruction
Library Management - Licensed Practical Nurse (LPN)
Licensed Professional Geologist - Life &amp; Health Insurance Licenses
Life &amp; Health Licenses - Life Science Industry
Life Sciences - Lifestyle Articles
Lifestyle Brands - Lifestyle Writing
Lifetime Value - Light Scattering
Light Sources - Lightning Conductor
Lightning Protection - Limdep
Lime - Line Art
Line Balance - Line of Sight
Linear Accelerators - Liners
Lines Of Credit - Link Building Campaigns
Link Exchange - LinkedIn Training
Linkedin Marketing - Linux Development
Linux Distributions - Lipid Disorders
Lipid Metabolism - Liquid Crystals
Liquid Handling - List Development
List Rental - Literary Editing
Literary Fiction - Lithium Batteries
Lithium-ion Batteries - Liturgical Dance
Liturgical Music - Live Meeting
Live Office - Live Video
Live Video Streaming - Livewire
Living Abroad - Loan Auditing
Loan Closings - Loans
Loans Administration - Local History
Local Marketing - Location Intelligence
Location Lighting - Locksmithing
Locomotive - Log4j
LogMeIn - Logic Models
Logic Pro - Logician
Logiciels RH - Logistics Design
Logistics Engineering - Lominger
Lominger Competencies - Long Range Planning
Long Term Acute Care - Longshore
Longview - Los Angeles
Loss Adjusting - Lotus Connections
Lotus Domino - Lovely Charts
Loving Life - Low Level Design
Low Level Programming - Lower Back
Lower Costs - Luminescence
Luminex - Lutherie
Lutron - LyX
Lyft - Lyricist
Lyrics - lynda.com news
M&amp;A Advisory Services - MADYMO
MALDI-MS - MBCS
MBD - MCSD
MCT - MEP Coordination
MEP Design - MIIS
MIL-STD - MLD
MLM - MOE
MOF - MPR
MPages - MS Project
MS Reporting Services - MSP Advanced Practitioner
MSP Practitioner - MVR
MVS - Mac Systems
Mac and Windows - Macintosh
Macintosh Applications - Maemo
Magazine Articles - Magnetic Particle Testing
Magnetic Recording - Mailers
Mailing List Management - Mainview
Major Account Acquisition - Makeup Artistry
Making Coffee - Manage Complex Projects
Manage Multiple - Management Consulting
Management Contracts - Management of small teams
Manager Selection - Managing Rapid Growth
Managing Technical Personnel - Manticore
Mantis - Manufacturing Productivity
Manufacturing Safety - Mapics
Maple - Marine Corps
Marine Electronics - Maritime Law Enforcement
Maritime Operations - Market Landscape Analysis
Market Making - Market Timing
Market Updates - Marketing Homes
Marketing Information Systems - Marketing par e-mail
Marketing y ventas - Maschinenbau-Konstruktion
Mascot - Master Agreements
Master Builder - Mastering
Mastermind Groups - Material Tracking
Material Transfer Agreements - Mathematical Physics
Mathematical Programming - Maturity Models
Matériaux 3D - Mazut
MbUnit - Mechanical Drawings
Mechanical Handling - Medals
Medi-Cal - Media Ethics
Media Evaluation - Media Prep
Media Preparation - Media Tools
Media Trained - Medical Communications
Medical Compliance - Medical Lasers
Medical Law - Medical Review
Medical Sales - Medicare Part D
Medicare Prescription Drug Plans - Mediums
Mediumship - Member of AICPA
Member of IEEE - Memorial Services
Memorials - Mental Ray
Mentalism - Merchant Services
Mercurial - Mesotherapy
Message Broker - Metabolomics
Metacognition - Metalworking Fluids
Metamaterials - Metric Development
Metric Management - Microarray
Microarray Analysis - Microemulsions
Microfabrication - Microscopy
Microseismic - Microsoft Development
Microsoft Dynamics - Microsoft Outlook
Microsoft Paint 3D - Microsoft Teams
Microsoft Training - Middle Eastern Studies
Middle Eastern history - Military Aviation
Military Communications - Military Weapon Systems
Military Weapons Handling - Mind-Body Medicine
Mind-body - Minex
Mingle - MirrorView
Mirroring - Mitek
Mitel - Mobile
Mobile 2.0 - Mobile Data Services
Mobile Data Solutions - Mobile Internet
Mobile Learning - Mobile Strategy
Mobile Switching Centre Server (MSS) - Mock Interviews
Mockito - Model Validation
Model-Driven Architecture (MDA) - Modern Portfolio Theory
Modern Trade - Mold Inspections
Mold Remediation - Molecular Microbiology
Molecular Modeling - Money Market
Money Market Accounts - Monster
Monsters - Morocco
MorphX - Motels
Motherboards - Motor Drives
Motor Fleet - Mounting
Mouse - Moxa
Moxibustion - Multi-Device Design
Multi-District Litigation - Multi-channel Marketing
Multi-channel Retail - Multi-line Phone
Multi-location Management - MultiAd Creator
MultiDimensional eXpressions (MDX) - Multipathing
Multiphase Flow - Multivariate Statistics
Multivariate Testing - Musculoskeletal Physiotherapy
Musculoskeletal Radiology - Music Engraving
Music Events - Music Publishing
Music Remixing - MyBatis
MyChart - Métiers du design web
mIRC - mySAP
Negotiation
Nonprofit Organizations
New Business Opportunities
Newsletters
New Hires
Network Communications
Network Administration
Network Systems
Network-Attached Storage (NAS)
Nutrition
N - NABCEP Certified
NABERS - NAFTA
NAGPRA - NASD
NASDAQ - NBFC
NBS Specification - NCIC
NCIDQ - NCSS
NCSim - NDM
NDMP - NEMA
NEMS - NFL
NFP - NGP
NGS - NICE Call Recording
NICET - NIPS
NIR Spectroscopy - NLS
NLTK - NNMi
NNTP - NPL
NPO - NS-2
NS2 - NSN
NSOM - NTSC
NUI - NWDS
NX-OS - Nails
Name Change - Nanocomposites
Nanodrop - Nanomedicine
Nanoparticles - Narrative Analysis
Narrative Illustration - National Account Management
National Accounts - National Electrical Code
National Honor Society - National Retailers
National Sales Training - Native Instruments FM8
Native Plants - Natural Health Products
Natural History - Natural Products
Natural Resource Economics - Nature Photography
Nature Writing - Navigators
Navisphere - Neck Pain
Necklaces - Negative Pressure Wound Therapy
Neglected Tropical Diseases - Nemetschek Group
Nemo - Nephrology
Nero - NetApp Filers
NetBIOS - NetForum
NetIQ AppManager - NetSuite
NetSupport - Netfilter
Netflow - Netscout
Netscreen - Network Address Translation (NAT)
Network Administration - Network Biology
Network Building - Network Defense
Network Deployment - Network Function Virtualization
Network Hardware - Network Mapping
Network Marketing - Network Processors
Network Programming - Network Systems
Network Technologies - Network Troubleshooting
Network Virtualization - Networking Training
Netzwerk-Infrastruktur und Sicherheit - Neurobiology
Neurochemistry - Neuroengineering
Neurofeedback - Neurologists
Neurology - Neuropathology
Neuropathy - Neurorehabilitation
Neuroscience - New Account Acquisition
New Account Generation - New Business Procurement
New Business Set-up - New Drug Application (NDA)
New Features - New Home Construction
New Home Purchase - New Market Expansion
New Market Growth - New Media Strategy
New Media Studies - New Product Release
New Product Roll Out - New Site Development
New Store Development - New Trends
New Unit Openings - Newborn
Newborn Photography - News Writing
NewsBoss - Newsprint
Newsreading - Next-Generation Network (NGN)
NextGen - Niches
Nickel - Night Vision
Nightclub - Nimble
Nimbus - Nitric Oxide
Nitro - Node B
Node Package Manager - Nokia Qt
Nomad - Non-Qualified Deferred Compensation
Non-Violent Crisis Intervention - Non-infringement
Non-invasive Cardiology - Non-profit Fund Development
Non-profit Leadership - Nonfiction
Nonlinear - Nonwovens
Nook - Nortel DMS
Nortel Meridian - Norton Mobile Security
Norton Studio - Note Taking
Notepad - Novell Certified
Novell Identity Manager - Nuance Communications Products
Nuance eCopy - Nuclear Magnetic Resonance (NMR)
Nuclear Pharmacy - Nuclear Waste Management
Nucleic Acid - NumPy
Numara Footprints - Numeric Filing
Numerical Ability - Nurse Call
Nurse Practitioners - Nursing Homes
Nursing Management - Nutrition
Nutrition Education - nCode
nDo - npm, Inc.
Order Fulfillment
Online Advertising
Operating Systems
Organizational Development
Oracle HR
Operations Management
Organizational Structure
Office Administration
Oracle Database
Outsourcing
O - OASIS
OAT - OC4J
OCAP - ODD
ODE - OEM Management
OEM contracts - OGSYS
OH&amp;S - OLAP Cube Studio
OLE - OMB
OMB A-123 - OODBMS
OOH - OPUS
ORA - OS&amp;E
OS/2 - OSHA
OSHA 10-Hour - OSP Engineering
OSSEC - OVD
OWA - Object Modelling
Object Oriented Design - Object-oriented Languages
Object-oriented Software - Occam
Occlusion - Ocean Marine
Ocean Transportation - Oenology
Off-Page SEO - Office &amp; Industrial Moving
Office + Productivity Software - Office Buildings
Office Cleaning - Office Procedures
Office Solutions - Officers
Offline Editing - Offshore Funds
Offshore Investments - Offshore Team Leadership
Offshore Transition - Oil &amp; Gas Companies
Oil &amp; Gas Exploration - Oil Sands
Oil Spill Response - Oleochemicals
Olfaction - Omneon
Omnet++ - Omnipeek
Omnis - On-Premise Marketing
On-Screen Takeoff - On-camera Interviewing
On-camera Reporting - OnLocation
OnQ - One On One
One Piece Flow - OneNote
OneNote for Mac - Online Articles
Online Assessment - Online Catalogs
Online Communications - Online Databases
Online Dating - Online Inventory Management
Online Journalism - Online Music
Online News - Online Product Launches
Online Production - Online Technology
Online Testing - Onshore Operations
Onsite Coordination - Oozie
Op-eds - Open Database Connectivity (ODBC)
Open Educational Resources - Open Pages
Open Plan - Open Space
Open Space Facilitation - Open to Buy Management
Open-mindedness - OpenEdge
OpenEmbedded - OpenLaszlo
OpenLayers - OpenSER
OpenSIPS - OpenStack
OpenSuse - Openbravo
Opencart - Openshift
Opentaps - Operating Room
Operating Room Sales - Operational Analysis
Operational Assessment - Operational Law
Operational Optimization - Operational Systems
Operational Test &amp; Evaluation - Operations Execution
Operations Improvement - Opics
Opinion Pieces - Opportunity Tracking
Opposition - Optical Devices
Optical Drives - Optical Sensors
Optical Switching - Optimization
Optimization Algorithms - Option Valuation
Options - Optometry
OrCAD - Oracle Application Development Framework (ADF)
Oracle Application Express - Oracle Coherence
Oracle Collaboration Suite - Oracle Enterprise Manager
Oracle Financials - Oracle Manufacturing
Oracle OLAP - Oracle Reports
Oracle Retail - Oracle VM
Oracle Warehouse Builder - Oral Motor
Oral Pathology - Orca
Orcaflex - Order Routing
Order Sets - Orff
OrgPlus - Organic Growth
Organic Growth Strategies - Organization Digital Transformation
Organization Growth - Organizational Charts
Organizational Climate - Organizational Initiatives
Organizational Leadership - Organizational Psychology
Organizational Reengineering - Organized Retail Crime Prevention
Organizing Meetings - Original Concepts
Original Music - Ornithology
Orphan Drugs - Orthotics
Orton-Gillingham - Osteology
Osteopathic Manipulative Medicine - Outboard Gear
Outbound Marketing - Outdoor Industry
Outdoor Kitchens - Outils de productivité
Outings - Outlook pour Mac
Outlook.com - Outsider Art
Outsourced HR Services - Overeating
Overhaul - Oversight
Overstock - Oxidative Stress
Oxides - osCommerce
Performance Tuning
Public Speaking
Project Planning
Program Management
Public Relations
Public Policy
Problem Solving
Partnerships
Presentations
Pricing Strategy
P &amp; L Oversight - PAD
PADI - PC Anywhere
PC Games - PDE
PDF Creator - PE
PEAR - PGW
PHAST - PIOS
PIP - PMCS
PMD - POVRay
PPA - PS4
PSAT - PTLLS
PTMS - Pacific Islands
Pacing - Paid Search Strategy
Pain Management - Palmistry
Palo Alto Networks - Panorama
Panoramic Photography - Paradox
Paralegals - Parent-Teacher Communication
Parent-child Relationships - Partials
Participant Observation - Partner Management
Partner Portal - Passive Design
Passive Fire Protection - Patent Drawings
Patent Enforcement - Patient Care
Patient Communications - Pavement Engineering
Pavement Management - Payment Solutions
Payment Systems - Pedagogy
Pedal Steel Guitar - Pega PRPC
Pegasus - PeopleSoft Financial
PeopleTools - Performance Based Logistics
Performance Based Marketing - Performing
Performing Arts - Perming
Permission Marketing - Personal Drive
Personal Finance - Personalization
Personalized Medicine - Pet Food
Pet Insurance - Pharmaceutical Care
Pharmaceutical Companies - Pharmacy Automation
Pharmacy Benefit Management - Phing
Phishing - Photo Editing
Photo Essays - Photographic Printing
Photographie de mariage - Photoshop Express
Photoshop Extended - Physical Modeling
Physical Oceanography - Piano
Piano Education - Piloting
Pin-up - Pipetting
Piping - Placenta Encapsulation
Places of Worship - Plant Closure
Plant Consolidations - Planview
Planview Enterprise - Platform Architecture
Platform Design - Plex
Plexus - Poetry
Poetry Readings - Policy Based Routing
Policy Compliance - Political Organization
Political Participation - Polymer Blends
Polymer Characterization - Pop-ups
Popcorn - Portfolio Marketing
Portfolio Optimization - Positouch
Positron Emission Tomography - Postal Automation
Postal Optimization - Powder Metallurgy
Powder Processing - Power Integrity
Power Management - PowerFlex
PowerMill - Powersports
Powertrain - Pre-construction
Pre-development - Precision Machining
Precision Measuring - Premium Career
Premium Financing - Presidency
Presidents Club - Pressure Vessels
Pressure Washing - Primary Care
Primary Care Physicians - Print Brokering
Print Collateral - Prioritize Workload
Priority Management - Private Events
Private Foundations - Pro Tools
Pro*C - Probability
Probability Theory - Proceeds of Crime
Procesamiento de texto - Process Integration
Process Intensification - Process Transitioning
Process Validation - Product Compliance
Product Concept - Product Lifecycle Management
Product Lines - Product Sourcing
Product Specialists - Production Equipment
Production Execution - Productividad
Productividad personal - Professional Malpractice
Professional Manner - Profit Analysis
Profit Center Management - Program Development
Program Direction - Programming Concepts
Programming Foundations - Project Design
Project Direction - Project Remediation
Project Resourcing - Projektmanagement und Organisation
Projektmanagement-Software - Pronunciation
Proof - Property Photography
Property Preservation - Prospect Research
Prospecting Skills - Protein Production
Protein Purification - Provider Education
Provider Enrollment - Psychoacoustics
Psychoanalysis - Public Affairs
Public Archaeology - Public Lands
Public Law - Public Space
Public Speaking - Pulmonology
Pulp - Purchase Recommendations
Purchase Requisitions - Pyrography
Pyrolysis - phpDocumentor
Qualitative Research
Queues
QuickBooks
Quality System
Quotations
Quality Auditing
Quantitative Research
Qualifying Prospects
Quality Improvement
Query Writing
Q&amp;A - Q-TOF
Q.931 - QA Engineering
QAC - QADirector
QALoad - QAQC
QARun - QB
QC 9.2 - QCAT
QEMU - QGIS
QI - QIP
QIPP - QLab
QMF for Windows - QNX
QNXT - QPSK
QPST - QR Code
QRC - QROPS
QRadar - QS9000
QSA - QSC
QSE - QSIG
QSR - QTS
QUMAS - Qigong
Qik - Qlik
Qlik Sense - QlikView Development
QlikWiew - Qmail
Qooxdoo - Qt Creator
Quadralay WebWorks Publisher - Quagga
Qualcomm BREW - Qualification Testing
Qualified Chartered Accountant - Qualified Mediator
Qualified Retirement Plans - Qualifying Candidates
Qualifying Opportunities - Qualitative &amp; Quantitative Research Methodologies
Qualitative Data - Quality Assurance Processes
Quality Assurance Professionals - Quality Auditing
Quality Certification - Quality Consulting
Quality Improvement - Quality Investigations
Quality Measures - Quality Operations
Quality Oriented - Quality Procedures
Quality Process Development - Quality Reporting
Quality Reviews - Quality System
Quality System Compliance - Quality by Design
Quality of Service (QoS) - Qualnet
Qualtrics - Quancept
QuantLib - Quantcast
Quantel - Quantitation
Quantitative Analytics - Quantitative Finance
Quantitative Genetics - Quantitative Investment Strategies
Quantitative Management - Quantitative Research
Quantitative Risk - Quantity Surveying
Quantity Take-offs - Quantum Computing
Quantum Dots - Quantum GIS
Quantum Information - Quantum Optics
Quantum Theory - QuarkXPress
QuarkXpress Interactive - Quarterly Reporting
Quarterly Reviews - Quartz
Quartz Composer - Quattro Pro
Qube - Query Builder
Query Designer - Query Optimization
Query Resolution - Query Tool
Query Tree - Query Writing
Query400 - Quest Design
Quest Migration Manager - Quest Tools
Quest vWorkspace - Question Answering
Question Based Selling - QuestionPro
Questionnaire Design - Queue Management
Queues - Qui Tam
Quick Changeover - Quick Reference Guides
Quick Service - Quick Start Guides
Quick Study - Quick Witted
QuickBase - QuickBooks Online
QuickBooks Payroll - QuickBooks for Mac
QuickFIX - Quickcut
Quicken - Quickness
Quickplace - Quicksilver
Quicktime - Quikjob
Quilting - Quintum
Quit - Quixel
Quiz - Quora
Quota Achievement - Quota Setting
Quotas - Quote
Quote Preparation - qRT-PCR
Research
Retail
Recruiting
Real Estate
Reviews
Requirements Analysis
Range
Regulations
Residential Homes
Records
R - R13
R14 - RAFT
RAID - RBI
RC - RCV
RDA - REBT
RED MX - RF &amp; Microwave Design
RF Circuits - RFI
RFID - RHEL
RHEV - RISA
RISC - RNA Biology
RNA Isolation - ROLAP
ROOT - RPOs
RPR - RSA Security
RSA Tokens - RTCP
RTD - RTMS
RTO - RabbitMQ
Race &amp; Ethnic Relations - Radian6
Radiance - Radio Broadcasting
Radio Communication - Radio-Frequency Identification (RFID)
Radioactive Materials - Radiopharmacy
Radioss - Railroad Law
Railroad Litigation - Raman Microscopy
Raman Spectroscopy - Rap
Rapid Application Development (RAD) - Rare Books
Rare Diseases - Ratings Advisory
Rational Apex - Rational Team Concert
Rational Test Manager - Re-engineering
Re-entry - Reactor
Reactor Design - Reagents
Reaktor - Real Estate Lending
Real Estate License - Real Time Reports
Real Time Streaming Protocol (RTSP) - Real-time Simulation
Real-time Web - Rebalancing
Rebar - Receptor Binding Assays
Receptor Pharmacology - Recon
ReconNet - Record Of Success
Record Storage - Recovery Planning
Recovery Plans - Rectifier
Recurring Billing - Red Hat Linux
Red Prairie - RediPlus
Redis - RefWorks
Refactoring - Refinery Operations
Refining - Refractory
Refrigerated Containers - Regional Anesthesia
Regional Banks - Registered Retirement Savings Plan (RRSP)
Registered Tax Agent - Regulatory Audits
Regulatory Capital - Regulatory Requirements
Regulatory Risk - Reid Technique of Interviewing &amp; Interrogation
Reiki - Relational Problems
Relationship Building - Relay
Relay Logic - Religion
Religious Buildings - Remediation Technologies
Remember the Milk - Remote Development
Remote Device Management - Remote Troubleshooting
Remote User Support - Renegotiations
Renewable Energy - Rent Manager
Rent Roll - Replication
Replication Technologies - Reporting Applications
Reporting Design - Reproduction
Reproductive Biology - RequireJS
Requirement Specifications - ResCheck
Resale Homes - Research Planning
Research Projects - Reservoir Modeling
Reservoir Simulation - Residential Income
Residential Income Properties - Resistivity
Resistors - Resource Estimation
Resource Leveling - Respiratory Therapy
Respite - Restless Leg Syndrome
Restlet - Restylane
ResultsPlus - Retail Displays
Retail Distribution - Retained Search
Retainers - Retirement Plan Consulting
Retirement Planning - Retro
Retro-Commissioning - Rev3
Revegetation - Reverse Engineering
Reverse Logistics - Revit MEP
Revit Structure - Rheumatoid Arthritis
Rheumatology - Ricardo Wave
Rice - Right Brain
Right First Time - Rings
Ringtail - Risk Engineering
Risk Financing - Risk Registers
Risk Reviews - Road
Road Biking - Roadside Assistance
Roadway Design - Robotic Surgery
Robotic Welding - Rodeo
Rogue Wave - Rollers
Rolling - Roof Coatings
Roof Gardens - Ropes
Rorschach - Rough Diamonds
Roulette - Routing and Remote Access Service 
Rowbyte - Ruby on Rails
RubyMine - Runes
Running - Russian
Russian History - reveal.js
Strategic Planning
Social Media
Staff Development
Sales Management
Strategy
Software
Supervisory Skills
SQL
Software Documentation
Schedules
S Corporations - SAP ALE
SAP APO - SAP HR
SAP IS - SAP Testing
SAP Travel Management - SCA
SCADA - SDKs
SDL - SESAM
SEU - SIOP
SIOR - SME Banking
SME Consulting - SOAR
SOC 1 - SPMI
SPML - SQLBase
SQLCE - ST&amp;E
STAAD - SY0-401
SY0-501 - Safety Improvements
Safety Instrumented Systems - Salads
Salary - Sales Finance
Sales Force Alignment - Sales Tax
Sales Tools Development - Sand Control
Sandals - Sauna
Saute - Scenario Development
Scenario Planning - School Events
School Health - Scientific Reports
Scientific Review - Screen Repair
Screen Scraping - Scuba Diving Instruction
Sculptra - Second Home
Second Home Market - Secured Transactions
Securities - Security Metrics
Security Operations - Segregated Funds
Segregation of Duties - Self-Service Solutions
Self-assembled Monolayers - Semiconductor Failure Analysis
Semiconductor IP - Sensitivity Training
Sensor Fusion - Serial Protocols
Serialization - Service Activation
Service Assurance - Service Manager 7
Service Matters - Servoy
Session Border Controller - Shadowing
Shaft Alignment - Shareholder Protection
Shareholder Value - Shippers
Shipping - Short Term Medical
Shortage Control - SiGe
Sibelius - Signal Transfer Point (STP)
SignalR - Silverpop Engage
Silversmithing - Single Camera
Single Engine Land - Site Integration
Site Investigation - Size Exclusion
Sizing - Skip Tracing
Skire - Slope Stability
Slope Stability Analysis - Small Press Publishing
Small Project Management - SmartStation
Smartbit - Snoring
Snorkeling - Social Dance
Social Design - Social Media Blogging
Social Media Coaching - Social Stratification
Social Studies - Soft Systems Methodology
Soft Tissue - Software Contracts
Software Conversions - Software Patents
Software Planning - Softwaredesign
Softwareverteilung - Sole Proprietors
Sole Traders - Solution Implementation
Solution Orientated - Sony Z1U
Sophis - Soundtrack Pro
Soups - Space Exploration
Space Law - Speaker Acquisition
Speaker Development - Specialty Items
Specialty Lines - Speech Technology
Speech Therapy - Spiral Dynamics
Spirent - Sports Chiropractic
Sports Clubs - Spot Production
Spot Removal - Springer Miller
Springer Miller Systems - Stack
Stadiums - Stagefright
Stages of Change - Standees
Stanislavski - State Estimation
State Government - Statistical Packages
Statistical Physics - Steel Plant
Steel Structures - Stigma
Still Life - Stone Carving
Stone Massage - Storis
Stork - Strata Management
Strata View - Strategic Improvement
Strategic Influence - Strategic Transformation
Strategic Use Of Technology - Street Team Management
Street Teams - Structural Biology
Structural Calculations - Strut
Struts - Studio Art
Studio Camera Operation - Subaru
Subbing - Substation Automation
Substation Design - Summit
Summits - Superalloys
Superannuation - Supply Network Planning
Supply Operations - Surface Metrology
Surface Mining - Surrogacy
Surround Sound - Sustainable Business
Sustainable Business Strategies - Swedish Massage
Sweep Accounts - Sylenth
Syllabus Development - Synopsis
Synopsys Primetime - System Center Virtual Machine Manager (SCVMM)
System Configuration - System of Systems Engineering
System on a Chip (SoC) - solid-state NMR
Training
Teamwork
Team Leadership
Teaching
Team Building
Testing
Time Management
Team Management
Troubleshooting
Telecommunications
T cells - T5i
TA2000 - TBEM
TBMCS - TDM
TDMoIP - TFT
TFTP - TIP
TIRF - TMON
TMS320 - TPE
TPF - TREX
TRI - TSRM
TSS - TVC
TVCs - Tabletop
Tablets - Tactics
Taekwondo - Taking New Products to Market
Takt - Talking Points
Tally ERP - Tape
Tape Backup - Target Marketing
Target Orientation - Tas Books
Tascam - Tax Advisory
Tax Analysis - Tax Investigations
Tax Law - Taxations
Taxidermy - Teaching English as a Foreign Language
Teaching English as a Second Language - Team Foundation Server
Team Foundation Server (TFS) - Team Training
Team Workshops - Techlog
Technical Ability - Technical Discussions
Technical Documentation - Technical Papers
Technical Planning - Technical Research
Technical Resource Management - Technical Transfers
Technical Translation - Technological Proficiency
Technological Solutions - Technology Evaluation
Technology Evangelism - Technology Recruitment
Technology Research - Tecplot
Tectonics - Telecom
Telecom BSS - Teleform
Telefundraising - Teleprompter
Teleprompter Operation - Tellabs 5500
Teller Operations - Tempo
Temporary Displays - Tender Development
Tender Management - Tents
Tequila - Termite
TerraSync - Test &amp; Measurement Instrumentation
Test Assurance - Test Estimation
Test Execution - Test Protocols
Test Requirements - Testability
Testers - Text Analytics
Text Classification - Texts
Textual Analysis - Thai Massage
Thanatology - Theme Parks
Themed Entertainment - Therm
Thermage - Thermal Spray
Thermal System Design - Thickening
Thigh Lift - Third Party Billing
Third Party Claims - Thomson Reuters Eikon
ThomsonOne - Throughput
Thunderbird - Tier II
Tier II Reporting - Time &amp; Attendance
Time Clocks - TimeMap
Timekeeping - Tinting
Tiny Term - Title 24
Title Clearing - Tizen
Tk - Tokenization
Tokens - Toner Cartridges
Toning - Topgrading
Topic Maps - Torts
Toshiba - Touchpaper
Tour Accounting - Town Hall Meetings
Townhomes - TraceMaster
TracePro - Trade Agreements
Trade Associations - Trade Regulation
Trade Secrets - Trading
Trading Cards - Traffic Building
Traffic Calming - Traffic Violations
Traffix - Training Course Development
Training Delivery - Traitement de texte
Trajectory Analysis - Transaction Support
Transaction Tax - Transdermal
Transducers - Transformational Projects
Transformations - Transitional Justice
Translation - Transnationalism
Transparency - Transportation Policy
Transportation Procurement - Trauma Survivors
Trauma Therapy - Travel Management
Travel Marketing - Treasury Management
Treasury Services - Trend Analysis
Trend Awareness - TrialWorks
Trials - Trigeminal Neuralgia
Trigger Point Therapy - Tripwire Enterprise
Triton - Trucking
Trucking Litigation - Trust Taxation
Trusted Business Advisor - Tumbling
Tumblr - TurboGears
Turbojet - Turnitin
Turnkey Projects - Twinfield
Twist - TypeMock
TypeScript - tvOS
Unix
User Interface Design
User Experience
U.S. Health Insurance Portability and Accountability Act (HIPAA)
Underwriting
U.S. Department of Defense
UMA
Unified Modeling Language (UML)
University Teaching
User Acceptance Testing
U&amp;A - U.S. Department of Agriculture (USDA)
U.S. Department of Defense - U.S. FHA Financing
U.S. Fair Debt Collection Practices Act (FDCPA) - U.S. Federal Information Security Management Act (FISMA)
U.S. Food and Drug Administration (FDA) - U.S. Generally Accepted Accounting Principles (GAAP)
U.S. Health Insurance Portability and Accountability Act (HIPAA) - U.S. National Incident Management System (NIMS)
U.S. National Registry of Emergency Medical Technicians (NREMT) - U.S. Securities and Exchange Commission (SEC)
U.S. Title 21 CFR Part 11 Regulation - U4ia
UAD-2 / Apollo - UB04
UB92 - UCC filings
UCCE - UCP 600
UCS - UDF
UDS - UF/DF
UFC - UHF
UI Automation - UK Bribery Act
UK Corporation Tax - UK Tax
UL - UMLS
UMTS Terrestrial Radio Access Network (UTRAN) - UNIX Utilities
UPC - UPS Systems
UPnP - US Equities
US Healthcare - US Tax
US Treasuries - USB3.0
USCG Captain - USGBC
USIM - USPV
UST - UV coating
UV disinfection - UWB
UX - Ubercart
Ubiquiti Networks - Ufile
Ukrainian - Ulead VideoStudio
Ultiboard - Ultipro
Ultra - UltraEdit
UltraTax - Ultrafiltration
Ultramicrotomy - Ultrasound Therapy
Umbilicals - Unanet
Unbiased - Uncertainty Quantification
Unconventional - Underfloor Heating
Undergraduate Teaching - Underscore.js
Undersea Warfare - Underwater Photography
Underwater Video - Unfair Labor Practice Charges
Unfair Trade Practices - Unica
Unica Affinium Campaign - Unicenter TNG
Unicode - Unifi
Unified Communications - Unified Presence
Unified Process - Uniform Programs
Uniforms - Union Avoidance
Union Contracts - Union Relations
Union Relationships - Unique Selling Proposition
Uniqueness - Unit Costing
Unit Investment Trusts - Unit Production Management
Unit Testing - Unity
Unity 2D - Unity Technologies
Unity3D - Universal Design for Learning
Universal Life - Universities
University Recruitment - Unix Administration
Unix Networking - Unlawful Detainer
Unloading - Unreal 3
Unreal Editor - UnrealScript
Unsecured Loans - Untangle
Unternehmertum - Updos
Upgradation - Upper Extremity
Upsizing - Uptime
Uranium - Urban Art
Urban Culture - Urban Economics
Urban Education - Urban Geography
Urban History - Urban Ministry
Urban Music - Urban Regeneration
Urban Search - Urbanism
Urbanization - Urethane
Urgency - Urodynamics
Urogynecology - Usability Labs
Usability Testing - Use Case Diagrams
Use Tax - User Adoption
User Analysis - User Datagram Protocol (UDP)
User Defined Functions - User Experience Design
User Experience Testing - User Groups
User Guide Creation - User Interface Prototyping
User Interface Specifications - User Manager
User Manual Development - User Requirements
User Research - User Training
User-centered Design - Utilities Management
Utility Analysis - Utility Industry
Utility Law - Utility Regulation
Utility Systems - Utilization Review
Uveitis - uClinux
uDig - uniPaaS
Vendor Management
Video
Video Production
Volunteering
Validation
Vendors
Volunteer Management
Video Editing
Visual Merchandising
Visio
V Lookups - V3 Foundation
V5 - VAR Recruitment
VARTM - VAWA
VAX - VCAT
VCI - VDA
VDI - VEX
VFX Supervision - VILT
VIO - VISSIM
VISUM - VLS
VLSI CAD - VMI
VMI Programs - VMware NSX
VMware Player - VNA
VO - VPP
VPython - VSA
VSAM - VSS
VST - VTK
VTL - VUVOX
VW - Vacant Land Sales
Vacant Lots - Vacuum Chambers
Vacuum Deposition - Valgrind
Validation - Valuation
Valuation Modeling - Value Driven
Value Engineering - Value Stream Mapping
Value Stream Maps - Values-based Leadership
Valve Hammer Editor - Vapor Intrusion
Variable Annuities - Variable Pay Design
Variable Products - Variation Analysis
Variation Reduction - Vascular
Vascular Biology - Vector
Vector CANalyzer - VectorScribe
Vectoring - Veeva
Vegan - Vegetarian Nutrition
Vegetation - Vehicle Leasing
Vehicle Lettering - Vehicle Wrap Design
Veils - Vendor Finance
Vendor Managed Inventory - Venetian Plaster
Venipuncture - Ventura Publisher
Venture Capital - Venue Development
Venue Dressing - Verbal De-escalation
Verdi - Veritas Cluster Server
Veritas Storage Foundation - Version Control Tools
Version Cue - Vertical Mapper
Vertical Market - Very-Large-Scale Integration (VLSI)
Vessel Management - Veterans Affairs
Veterans Benefits - Veterinary Surgery
Veterinary Technology - Vibration Control
Vibration Isolation - Victorian literature
Video - Video Cameras
Video Capture - Video Conferencing
Video Copilot - Video Equipment
Video Ethnography - Video Journalism
Video Lighting - Video Post-Production
Video Pre-Production - Video Sharing
Video Standards - Video-Farbkorrektur
Videoausrüstung - Vietnamese
Viewlogic - Vim
Vimeo - Vinyl Cutting
Vinyl Siding - Viral Video
Virology - Virtual Communities
Virtual Computing - Virtual Directory
Virtual Economies - Virtual Learning
Virtual Machine Manager - Virtual Office
Virtual PC - Virtual Routing and Forwarding (VRF)
Virtual Screening - Virtual Worlds
VirtualBox - Virtuemart
Virtuoso - VisView
Visas - Vision Casting
Vision Creation - Visioneering
Visit - Visma
Vista - Visual Basic
Visual Basic .NET (VB.NET) - Visual Composer
Visual Concepts - Visual Effects und Compositing
Visual Enterprise - Visual Interdev
Visual Journalism - Visual Merchandising
Visual Metrics - Visual Rhetoric
Visual SVN - Visual Studio Express
Visual Studio Team System - VisualAge
VisualDSP++ - Visualization
Visualization Software - Vitiligo
Vitria - Vizio
Viztopia - Vocal Instruction
Vocal Jazz - Vocera
Vocus - Voice Dialogue
Voice Direction - Voice Processing
Voice Quality - Voice User Interface Design
Voice of the Customer - Voicing
Voids - Volleyball
Voltage - Volume Testing
Volumetric - Volunteer Management
Volunteer Recruiting - Vorträge
Votebuilder - Vouchers
Vovici - Vue xStream
Vue.js - VxFS
VxWorks - v8i
vBlock - vSphere High Availability
video2brain - video2brain
Windows
Writing
Web Design
Web Development
Windows Server
Workshops
Web Applications
Water Resource Management
WordPress
Wireless Technologies
W-2 - WAIK
WAIS - WAWF
WBE - WDF
WDK - WGA
WHIMS - WISP
WLAN - WMS Implementations
WMV - WPS
WRAP - WSE
WSGI - WTO
WTP - Wafer
Wafer Bonding - Wakeboarding
Wal-Mart - Wallcoverings
Wallets - Warehouse Lending
Warehouse Management Systems - Washers
Washes - Waste Water Treatment Plants
Waste to Energy - Water Aerobics
Water Analysis - Water Footprinting
Water Gardens - Water Quality
Water Quality Modeling - Water Sensitive Urban Design
Water Skiing - WaterGEMS
Waterbirth - Waterjet
Watermarking - Wave Energy
Wave Propagation - Wavelets
Waves - Wealth Preservation
Wealth Preservation Planning - Wearables
Weather - Web 2.0
Web 2.0 Development - Web Applications
Web Apps - Web Collaboration
Web Commercials - Web Crawling
Web Design - Web Governance
Web Graphics - Web Media
Web Metrics - Web Products
Web Project Management - Web Services API
Web Services Description Language (WSDL) - Web Text
Web Tracking - Web-based Project Management
Web-based Reporting - WebCT
WebCenter - WebInspect
WebKit - WebSphere Application Server
WebSphere Business Integration - WebUI
WebWorks - Webisodes
Weblogic Administration - Websense
Website Administration - Website Translation
Website Updating - Wedding Cakes
Wedding Coordinating - Wedding Planning
Wedding Videos - Weight Management
Weight Training - Well Construction
Well Control - Wellbeing
Wellbore Stability - Western Europe
Western analysis - WhatsUp
Wheat - White Box
White Box Testing - Whittle
Whole Brain Thinking - Wholesale Purchasing
Wholesale Real Estate - Wideband Code Division Multiple Access (WCDMA)
Widening Participation - Wikipedia
Wikis - Wildland Fire
Wildland Firefighting - Wilson Reading
Wily Introscope - WinCC
WinDbg - WinQSB
WinRAR - Wincross
Wind Energy - WindPro
WindRiver - Window Dressing
Window Film - Windows 8.1
Windows 95 - Windows Domain
Windows Driver Development - Windows Live Movie Maker
Windows Mail - Windows Movie Maker
Windows NT - Windows Server
Windows Services - Windows kernel programming
Windows software development - Wine Lists
Wine Marketing - Winsock
Wintel - Wire Wrapping
Wirecast - Wireless Engineering
Wireless Expense Management - Wireless Sensor Networks
Wireless Site Surveys - Wise Packaging Studio
Wit - Wolof
Wombat - WooCommerce
Wood - Wooji Juice
Wool - Word para Mac
Word pour Mac - Wordsmithing
Wordstar - Work Management
Work Orders - Work in Unison with Staff
Work-based Learning - Workers' Compensation Claims
Workflow - Workforce Management
Workforce Performance - Working From Home
Working Memory - Working with Investors
Working with Juvenile Offenders - Workload Characterization
Workout - Workplace Relations
Workplace Relationships - Workshop Leadership
Workshop Moderation - Workwear
World Affairs - World Music
World Religions - Worst Case Analysis
Wound Care - Write-ups
Writer - Written Word
Wrongful Death Claims - wxWidgets
Xbox 360
XML
XHTML
X-ray
XSLT
Xcode
Xilinx
Xen
XSL
XAML
X - X 10.1
X 10.2 - X 10.3
X Insider Training - X++
X-Cart - X-Particles
X-T1 - X-T2
X-Trader - X-Ways
X-ray - X-ray Absorption Spectroscopy
X-ray Diffraction Analysis - X-ray Microanalysis
X-ray Spectroscopy - X-ray Vision
X-ray crystallography - X-ray diffractometry
X.25 - X.400
X.500 - X.509
X10 - X11
X12 - X2
X264 - X3
X3D - X4
X5 - X6
X64 - X7
X8 - X86
X86 Virtualization - XACML
XACT - XAML
XAMPP - XATA
XAUI - XBAP
XBMC - XBR
XBRL - XCAL
XCAP - XCOM
XDCAM - XDoclet
XFDTD - XFOIL
XFP - XFS
XFire - XForms
XHTML - XI
XLMiner - XLSTAT
XML - XML Databases
XML Gateway - XML Programming
XML Publisher - XML Schema
XML Schema Definition (XSD) - XML Schema Design
XML Scripting - XML Sitemaps
XML Spy - XML Standards
XML-RPC - XMLBeans
XMLHTTP - XMLP
XMPP - XMPie
XMetal - XMind
XOG - XP
XP Professional - XP/Vista/7
XPAC - XPCOM
XPDL - XPS
XPages - XPath
XPlanner - XQuery
XRF - XRR
XRY - XSI
XSL - XSL-FO
XSLT - XSP
XSS - XStream
XTRAC - XTRACT
XUL - XXX
XaaS - Xactimate
Xactly - Xactly Incent
Xajax - Xalan
Xamarin - Xara
Xbox - Xbox 360
Xbox One - Xcalibur
Xcelsius - Xcode
Xdebug - Xemacs
Xen - XenApp
XenClient - Xenix
Xenu - Xerces
Xeriscape - Xeriscaping
Xero - Xerox Printers
Xetra - Xign
Xilinx - Xilinx ISE
Xinet - Xing
Xinox Software - Xoops
Xpediter - Xperia
Xplan - Xpress
Xpress Pro - Xsan
Xserve - Xsigo
Xytech - x86 Assembly
xBase - xCAT
xCP - xPC Target
xPON - xPression
xSeries - xUnit
YAML
YMS
YSlow
YUI Library
YUM
Yacc
Yacht Charters
Yacht Clubs
Yacht Deliveries
Yacht Racing
Yachting
Yahoo Search
Yahoo Search Marketing
Yahoo Site Explorer
Yahoo!
Yamaha Digital Consoles
Yamaha M7CL
Yamaha PM5D
Yammer
Yantra
Yard Management
Yard Signs
Yard Work
Yardi
Yardi Enterprise
Yardi Property Management
Yardi Voyager
Yarn
Yaskawa
Year End Accounts
Year-end Close
Yearbook
Yeast
Yeast two-hybrid
Yellow Belt
Yellow Book
Yellow Pages
Yelp
Yelp, Inc.
Yeoman
Yiddish
Yield
Yield Management
Yields
Yieldstar
Yii
Yin Yoga
YoYo
Yodeling
Yoga
Yoga Instruction
Yoga Nidra
Yogurt
Yooda
Yooda Insight
Yoruba
Yosemite
YouTube
YouTube API
Young Adult Literature
Young Adult Services
Young Adults
Young People
Young Professionals
YourKit
Yourdon
Youth Activism
Youth Advocacy
Youth At Risk
Youth Culture
Youth Development
Youth Empowerment
Youth Engagement
Youth Entrepreneurship
Youth Groups
Youth Justice
Youth Leadership
Youth Leadership Training
Youth Marketing
Youth Media
Youth Mentoring
Youth Ministry
Youth Organizations
Youth Outreach
Youth Participation
Youth Programs
Youth Services
Youth Work
Yelp.com
Z-Shell
Z-Wave
Z1
Z80
ZBrush
ZBrushCore
ZFS
ZK
ZPL
ZURB
Zabbix
Zachman
Zainet
Zapier
ZaxWorks
Zebra
Zebrafish
Zedo
Zeichnen
Zeiss
Zemax
Zen
Zen Shiatsu
ZenCart
Zend
Zend Certified Engineer
Zend Framework
Zend Server
Zend Studio
Zendesk
Zenoss
Zenworks
Zeolites
Zephyr
Zephyr Style Advisor
Zeplin
Zero Balancing
Zero Defects
Zero Waste
Zero-based Budgeting
ZeroMQ
Zeta Potential
Zeus
ZigBee
Zillow
Zimbra
Zinc
Zines
Zmap
Zoho
Zombies
Zone Alarm
Zoning
Zoo
Zooarchaeology
Zoology
Zoom
ZoomInfo
ZoomText
Zoomerang
Zope
Zotero
Zsh
Zuken
Zultys
Zulu Education Products
ZuluDesk
Zumba
Zumba Instruction
Zuora
Zymography
Zynx
Zyxel
Z/OS
Z/VM
ZLinux
ZSeries